10 25 60 50
########@@@@@&&&@@@@#####
# %          %          @
@ @@@@@@  D @@++@@     @@
# @ % @@      ###       @
@+@           #&&     % @
#             @@@      &@
@&##     %              #
#      @@@@             #
@ %    @+&@      /      #
##    ##@@@@##    ###+###