10 20 30 -1
########@@@@@@@@@@@@
# %          %     @
@ @@@@@@  D @@@@@@@@
# @   @@      ###  @
@ @           ###% @
#             @@@ @@
@ ##               #
#      @@@@        #
@ %    @@@@      / #
########@@@@#########