10 25 30 10
########@@@@@&&&@@@@#####
# %          %          @
@ @@&&@@  D @@++@@     @@
# @ % @@      ###       &
@+@           #&&       @
#             @&@      &@
@&##     %              #
#      @@@@             #
@ %    @+&&      /      #
##   +##@@@@##    ###+###