10 23 60 10
#######################
#@      @@@        /  #
#        @       ###  #
#      %          ### #
#@         @@@@ @@@@  #
#          @       @  #
# % @      @@@@ @@@@  #
#                     #
# % @@@@@          D  #
#######################